XXXXXXXXXXXXXXXXXXXXXXXXXXXXXXXXXXXXXXXXXXXXXXXXXXXXXXXXXXXXX
XHHHHHHHHHHHHHHHHHHHHHHHHHHHHHHHHHHHHHHHHHHHHHHHHHHHHHHHHHHHX
X                                                           X
X                                                           X
X                                                           X
X                                                           X
X                                                           X
X                                                           X
X                                                           X
X                                                           X
X                                                           X
X                                                           X
X                                                           X
X                                                           X
X                                                           X
X                                                           X
X                                                           X
X                                                           X
X                                                           X
X                                                           X
X                                                           X
X                                                           X
X                                                           X
X                                                           X
X                                                           X
X                                                           X
X                                                           X
X                                                           X
X                                                           X
X                                                           X
X                                                           X
X                                                           X
X                                                           X
X                                                           X
X                                                           X
X                                                           X
X                                                           X
X                                                           X
X                                                           X
X                                                           X
X                                                           X
X                                                           X
X                                                           X
X                                                           X
X                                                           X
X                                                           X
X                                                           X
X                                                           X
X                                                           X
X                                                           X
X                                                           X
X                                                           X
X                                                           X
X                                                           X
X                                                           X
X                                                           X
X                                                           X
X                                                           X
X                                                           X
X                                                           X
X                                                           X
X                                                           X
X                                                           X
X                                                           X
X                                                           X
X                                                           X
X                                                           X
X                                                           X
X                                                           X
X                                                           X
X                                                           X
X                                                           X
X                                                           X
X                                                           X
X                                                           X
X                                                           X
X                                                           X
X                                                           X
X                                                           X
X                                                           X
X                                                           X
XXXXXXXXXXXXXXXXXXXXXXXXXXXXXXXXXXXXXXXXXXXXXXXXXXXXXXXXXXXXX