XXXXXXXXXXXXXXXXXXXXXXXXXXXXXXXXXXXXXXXXXXXXXXXXXXXXXXXXXXXXXXXXXXXXXXXXXXXXXXXXXXXXXXXXXXXXXXXXXXXXX
XHHHHHHHHHHHHHHHHHHHHHHHHHHHHHHHHHHHHHHHHHHHHHHHHHHHHHHHHHHHHHHHHHHHHHHHHHHHHHHHHHHHHHHHHHHHHHHHHHHHX
X                                                                                                   X
X                                                                                                   X
X                                                                                                   X
X                                                                                                   X
X                                                                                                   X
X                                                                                                   X
X                                                                                                   X
X                                                                                                   X
X                                                                                                   X
X                                                                                                   X
X                                                                                                   X
X                                                                                                   X
X                                                                                                   X
X                                                                                                   X
X                                                                                                   X
X                                                                                                   X
X                                                                                                   X
X                                                                                                   X
X                                                                                                   X
X                                                                                                   X
X                                                                                                   X
X                                                                                                   X
X                                                                                                   X
X                                                                                                   X
X                                                                                                   X
X                                                                                                   X
X                                                                                                   X
X                                                                                                   X
X                                                                                                   X
X                                                                                                   X
X                                                                                                   X
X                                                                                                   X
X                                                                                                   X
X                                                                                                   X
X                                                                                                   X
X                                                                                                   X
X                                                                                                   X
X                                                                                                   X
X                                                                                                   X
X                                                                                                   X
X                                                                                                   X
X                                                                                                   X
X                                                                                                   X
X                                                                                                   X
X                                                                                                   X
X                                                                                                   X
X                                                                                                   X
X                                                                                                   X
X                                                                                                   X
X                                                                                                   X
X                                                                                                   X
X                                                                                                   X
X                                                                                                   X
X                                                                                                   X
X                                                                                                   X
X                                                                                                   X
X                                                                                                   X
X                                                                                                   X
X                                                                                                   X
X                                                                                                   X
X                                                                                                   X
X                                                                                                   X
X                                                                                                   X
X                                                                                                   X
X                                                                                                   X
X                                                                                                   X
X                                                                                                   X
X                                                                                                   X
X                                                                                                   X
X                                                                                                   X
X                                                                                                   X
X                                                                                                   X
X                                                                                                   X
X                                                                                                   X
X                                                                                                   X
X                                                                                                   X
X                                                                                                   X
X                                                                                                   X
X                                                                                                   X
X                                                                                                   X
X                                                                                                   X
X                                                                                                   X
X                                                                                                   X
X                                                                                                   X
X                                                                                                   X
X                                                                                                   X
X                                                                                                   X
X                                                                                                   X
X                                                                                                   X
X                                                                                                   X
X                                                                                                   X
X                                                                                                   X
X                                                                                                   X
X                                                                                                   X
X                                                                                                   X
X                                                                                                   X
X                                                                                                   X
X                                                                                                   X
X                                                                                                   X
XXXXXXXXXXXXXXXXXXXXXXXXXXXXXXXXXXXXXXXXXXXXXXXXXXXXXXXXXXXXXXXXXXXXXXXXXXXXXXXXXXXXXXXXXXXXXXXXXXXXX