XXXXXXXXXXXXXXXXXXXXXXXXXXXXXXXXXXXXXXXXXXXXXXXXXXXXXXXXXXXXXXXXXXXXXXXXXXXXX
XHHHHHHHHHHHHHHHHHHHHHHHHHHHHHHHHHHHHHHHHHHHHHHHHHHHHHHHHHHHHHHHHHHHHHHHHHHHX
X                                                                           X
X                                                                           X
X                                                                           X
X                                                                           X
X                                                                           X
X                                                                           X
X                                                                           X
X                                                                           X
X                                                                           X
X                                                                           X
X                                                                           X
X                                                                           X
X                                                                           X
X                                                                           X
X                                                                           X
X                                                                           X
X                                                                           X
X                                                                           X
X                                                                           X
X                                                                           X
X                                                                           X
X                                                                           X
X                                                                           X
X                                                                           X
X                                                                           X
X                                                                           X
X                                                                           X
X                                                                           X
X                                                                           X
X                                                                           X
X                                                                           X
X                                                                           X
X                                                                           X
X                                                                           X
X                                                                           X
X                                                                           X
X                                                                           X
X                                                                           X
X                                                                           X
X                                                                           X
X                                                                           X
X                                                                           X
X                                                                           X
X                                                                           X
X                                                                           X
X                                                                           X
X                                                                           X
X                                                                           X
X                                                                           X
X                                                                           X
XXXXXXXXXXXXXXXXXXXXXXXXXXXXXXXXXXXXXXXXXXXXXXXXXXXXXXXXXXXXXXXXXXXXXXXXXXXXX