XXXXXXXXXXXXXXXXXXXXXXXXXXXXXXXXXXXXXXXXXXXXXXXXXXX
XHHHHHHHHHHHHHHHHHHHHHHHHHHHHHHHHHHHHHHHHHHHHHHHHHX
X                                                 X
X                                                 X
X                                                 X
X                                                 X
X                                                 X
X                                                 X
X                                                 X
X                                                 X
X                                                 X
X                                                 X
X                                                 X
X                                                 X
X                                                 X
X                                                 X
X                                                 X
X                                                 X
X                                                 X
X                                                 X
X                                                 X
X                                                 X
X                                                 X
X                                                 X
X                                                 X
X                                                 X
X                                                 X
X                                                 X
X                                                 X
X                                                 X
X                                                 X
X                                                 X
X                                                 X
X                                                 X
X                                                 X
X                                                 X
X                                                 X
X                                                 X
X                                                 X
X                                                 X
X                                                 X
X                                                 X
X                                                 X
X                                                 X
X                                                 X
X                                                 X
X                                                 X
X                                                 X
X                                                 X
X                                                 X
X                                                 X
X                                                 X
X                                                 X
X                                                 X
X                                                 X
X                                                 X
X                                                 X
X                                                 X
X                                                 X
X                                                 X
X                                                 X
X                                                 X
X                                                 X
X                                                 X
X                                                 X
X                                                 X
X                                                 X
X                                                 X
X                                                 X
X                                                 X
X                                                 X
X                                                 X
X                                                 X
X                                                 X
X                                                 X
X                                                 X
X                                                 X
XXXXXXXXXXXXXXXXXXXXXXXXXXXXXXXXXXXXXXXXXXXXXXXXXXX