XXXXXXXXXXXXXXXXXXXXXXXXXXXXXXXXXXXXXXXXXXXXXXXXXXXXXXXXXXXXXXXXXXXXXXXXXXXXXXXXX
XHHHHHHHHHHHHHHHHHHHHHHHHHHHHHHHHHHHHHHHHHHHHHHHHHHHHHHHHHHHHHHHHHHHHHHHHHHHHHHHX
X                                                                               X
X                                                                               X
X                                                                               X
X                                                                               X
X                                                                               X
X                                                                               X
X                                                                               X
X                                                                               X
X                                                                               X
X                                                                               X
X                                                                               X
X                                                                               X
X                                                                               X
X                                                                               X
X                                                                               X
X                                                                               X
X                                                                               X
X                                                                               X
X                                                                               X
X                                                                               X
X                                                                               X
X                                                                               X
X                                                                               X
X                                                                               X
X                                                                               X
X                                                                               X
X                                                                               X
X                                                                               X
X                                                                               X
X                                                                               X
X                                                                               X
X                                                                               X
X                                                                               X
X                                                                               X
X                                                                               X
X                                                                               X
X                                                                               X
X                                                                               X
X                                                                               X
X                                                                               X
X                                                                               X
X                                                                               X
X                                                                               X
X                                                                               X
X                                                                               X
X                                                                               X
X                                                                               X
X                                                                               X
X                                                                               X
X                                                                               X
X                                                                               X
X                                                                               X
X                                                                               X
X                                                                               X
X                                                                               X
X                                                                               X
X                                                                               X
X                                                                               X
X                                                                               X
X                                                                               X
XXXXXXXXXXXXXXXXXXXXXXXXXXXXXXXXXXXXXXXXXXXXXXXXXXXXXXXXXXXXXXXXXXXXXXXXXXXXXXXXX