XXXXXXXXXXXXXXXXXXXXXXXXXXXXXXXXXXXXXXXXXXXXXXXXXXXXXXXXXX
XHHHHHHHHHHHHHHHHHHHHHHHHHHHHHHHHHHHHHHHHHHHHHHHHHHHHHHHHX
X                                                        X
X                                                        X
X                                                        X
X                                                        X
X                                                        X
X                                                        X
X                                                        X
X                                                        X
X                                                        X
X                                                        X
X                                                        X
X                                                        X
X                                                        X
X                                                        X
X                                                        X
X                                                        X
X                                                        X
X                                                        X
X                                                        X
X                                                        X
X                                                        X
X                                                        X
X                                                        X
X                                                        X
X                                                        X
X                                                        X
X                                                        X
X                                                        X
X                                                        X
X                                                        X
X                                                        X
X                                                        X
X                                                        X
X                                                        X
X                                                        X
X                                                        X
X                                                        X
X                                                        X
X                                                        X
X                                                        X
X                                                        X
X                                                        X
X                                                        X
X                                                        X
X                                                        X
X                                                        X
X                                                        X
X                                                        X
X                                                        X
X                                                        X
X                                                        X
X                                                        X
X                                                        X
X                                                        X
X                                                        X
X                                                        X
X                                                        X
X                                                        X
X                                                        X
X                                                        X
X                                                        X
X                                                        X
X                                                        X
X                                                        X
X                                                        X
X                                                        X
X                                                        X
X                                                        X
X                                                        X
X                                                        X
X                                                        X
X                                                        X
X                                                        X
X                                                        X
X                                                        X
X                                                        X
X                                                        X
X                                                        X
X                                                        X
X                                                        X
X                                                        X
X                                                        X
X                                                        X
X                                                        X
X                                                        X
X                                                        X
X                                                        X
X                                                        X
X                                                        X
X                                                        X
X                                                        X
X                                                        X
X                                                        X
X                                                        X
X                                                        X
X                                                        X
X                                                        X
X                                                        X
X                                                        X
X                                                        X
X                                                        X
X                                                        X
X                                                        X
X                                                        X
X                                                        X
X                                                        X
X                                                        X
X                                                        X
X                                                        X
X                                                        X
X                                                        X
X                                                        X
X                                                        X
X                                                        X
X                                                        X
X                                                        X
X                                                        X
X                                                        X
X                                                        X
X                                                        X
X                                                        X
X                                                        X
X                                                        X
X                                                        X
X                                                        X
X                                                        X
X                                                        X
X                                                        X
X                                                        X
X                                                        X
X                                                        X
X                                                        X
X                                                        X
X                                                        X
X                                                        X
X                                                        X
X                                                        X
X                                                        X
X                                                        X
X                                                        X
X                                                        X
X                                                        X
XXXXXXXXXXXXXXXXXXXXXXXXXXXXXXXXXXXXXXXXXXXXXXXXXXXXXXXXXX